1111111111111111111111111111111111
1E0000000000000C00000C000000000001
101001010010000010100100000H010101
1010010010101010001001000000010101
1P0000000C00C0000000000000000000C1
1111111111111111111111111111111111
