11111111111111
10E0000000H011
100000C1000011
1P00C0000000E1
11111111111111